a	AH
a(2)	EY
bottom	B AA T AH M
center	S EH N T ER
center(2)	S EH N ER
field	F IY L D
game	G EY M
left	L EH F T
mark	M AA R K
new	N UW
new(2)	N Y UW
on	AA N
on(2)	AO N
place	P L EY S
right	R AY T
start	S T AA R T
the	DH AH
the(2)	DH IY
top	T AA P
top(2)	T AO P
